1111111111111
100C0001C10P1
1E0C000010001
1111110000111
1111111111111
