111111111111111111111111111111111111111111111111111
110P00000010000000000000001000011111111111111111111
1100000000100000000000000000E0011111111111111111111
11000000000000000C000000001111111111111111111111111
110000000010000000000000000000011111111111111111111
110000000010000000000000000000011111111111111111111
11000000C0000000C0000000000000011111111111111111111
111111111111111111111111111111111111111111111111111
