11111111111111111111111111111111111111111111111111
110P0000001000000000000000100001111111111111111111
1100000000100000000000000000E001111111111111111111
11000000000000000C00000000111111111111111111111111
11000000001000000000000000000001111111111111111111
11000000001000000000000000000001111111111111111111
11000000C0000000C000000000000001111111111111111111
11111111111111111111111111111111111111111111111111
